mieczysław mieszko | mieczysława mieszka
abel achacy achacjusz aspazja bazyli Grzegorz izydor jakobina jakubina makary narcyz stefania strzeżysław sylwester telesfor | Abla Achacego Aspazji Bazylego Grzegorza izydora jakobiny jakubiny makarego narcyza stefanii Strzeżysława sylwestra telesfora
danuta piotr genowefa | danuty piotra genowefy
angelika aniela dobromir eugeniusz grzegorz izabela | angeliki Anieli dobromira eugeniusza grzegorza
edward emilian hania szymon | Edwarda emiliana hanny szymona
andrzej bolemir kacper kasper melchior baltazar | Andrzeja bolemira kacpra Kaspra Melchiora baltazara
julian Łucjan | juliana Łucjana
mścisław seweryn | mścisława seweryna
antoni borzymir julian julianna | Antoniego borzymira Juliana Juliany
dobrosław jan paweł Wilhelm | Dobrosława Jana pawła Wilhelma
feliks krzesimir matylda | feliksa krzesimira matyldy
antoni arkadiusz benedykt czesław czesława ernest | Antoniego Antoniusza Arkadiusza benedykta czesławy ernesta
bogumił bogusława weronika | bogumiła bogusławy weroniki
feliks radogost | feliksa radogosta
aleksander dąbrówka dobrawa domasław paweł | aleksandra dąbrówki dobrawy domasława pawła
marcel włodzimierz kevin | Marcela Marcelego włodzimierza kevina
antoni jan rościsław | Antoniego jana rościsława
bogumił jaropełk krystyna małgorzata piotr | bogumiła jaropełka krystyny małgorzaty piotra
andrzej bernard erwin henryk mariusz marta racimir sara | andrzeja bernarda erwina henryka mariusza marty racimira sary
dobiegniew fabian sebastian | dobiegniewa fabiana sebastiana
agnieszka jarosław jarosława | agnieszki jarosława jarosławy
anastazy dobromysł dorian marta wincenta | anastazji dobromysła doriana marty wincenty
jan maria | jana marii
felicja mirogniew rafaela rafał tymoteusz | felicji mirogniewa rafaeli rafała tymoteusza
miłosz miłowan miłowit paweł tatiana | miłosza miłowana miłowita pawła tatiany
paula paulina wanda | pauli pauliny wandy
angelika ilona julian | angeliki ilony juliana
agnieszka augustyn julian karol piotr radomir | agnieszki augustyna juliana karola piotra radomira
hanna walerian zdzisław | hanny waleriana zdzisława
feliks gerard maciej marcin martyna sebastian | feliksa gerarda macieja marcina martyny sebastiana
euzebiusz jan piotr | euzebiusza jana piotra
dobrochna ignacy paweł siemirad żegota | dobrochny ignacego pawła siemirada żegoty
joanna korneliusz maria miłosław miłosława | joanny korneliusza marii miłosławy
błażej maksym oskar stefan telimena | błażeja maksyma oskara stefana telimeny
andrzej gilbert jan joanna józef weronika witosława | andrzeja gilberta jana joanny józefa weroniki witosławy
aga agata jakub jan paweł piotr | agi agaty jakuba jana pawła piotra
antoni bogdan bohdan dorota ksenia szymon | antoniego bogdana bohdana doroty ksenii szymona
alfons parteniusz partenia romeusz romuald rozalia ryszard sulisław | alfonsa parteniusza partenii romeusza romualda rozalii ryszarda sulisława
gniewomir jan paweł piotr sebastian | gniewomira jana pawła piotra sebastiana
bernard eryk eryka | bernarda eryki
gabriel Jacenty elwira | gabriela jacek jacka jacentego elwiry
lucjan maria olgierd świętomira | Łucjana lucjana Lucjusza marii olgierda świętomiry
julian laurenty nora | juliana Laurentego nory
grzegorz jordan katarzyna toligniew | grzegorza jordana katarzyny toligniewa
dobiesława józef konrad krystyna lilian liliana mikołaj niemir niemira zenon cyryl | dobiesławy józefa konrada krystyny liliana liliany mikołaja niemiry zenona cyryla
georgina jordan jowita józef klaudiusz | georginy jordana jowity józefa klaudiusza
bernard dan danuta julianna | bernarda dana danuty julianny
donat franciszek julian konstanty łukasz niegomir zbigniew | donata donaty franciszka juliana konstantego łukasza niegomira zbigniewa zbyszko zbyszka
albert alberta krystiana więcesława zuzanna | alberty krystiany więcesławy zuzanny
arnold henryk konrad | arnolda henryka konrada
leon ludmiła ludomiła | leona ludmiły ludomiły
eleonora feliks teodor | eleonory feliksa teodora
marta małgorzata piotr wiktor | marty małgorzaty piotra wiktora
bądzimir damian piotr roma seweryn | bądzimira damiana piotra romy seweryna
bogurad bogusz boguta maciej piotr | bogurada bogusza boguty macieja piotra
bolebor cezary maciej małgorzata | bolebora cezarego macieja małgorzaty
aleksander bogumił cezariusz mirosław ewelina | aleksandra bogumiła cezariusza mirosława eweliny
aleksander anastazja gabriel gabriela sierosława | aleksandra anastazji gabriela gabrieli sierosławy
józef roman lech | józefa romana lecha
dobronieg roman | dobroniega romana
albin antoni antonina amelia feliks herakles joanna józef piotr | albina antoniego antoniny amelii feliksa heraklesa joanny józefa piotra
franciszek helena henryk krzysztof michał paweł piotr radosław | franciszka heleny henryka krzysztofa michała pawła piotra radosława
hieronim maryna | hieronima maryny
adrian adrianna arkadiusz eugeniusz kazimierz lucja | adriana adrianny arkadiusza eugeniusza kazimierza lucji
adrian adrianna fryderyk jan wacław wacława | adriana adrianny fryderyka jana wacława wacławy
eugenia jordan klaudian róża wiktor wojsław | eugenii jordana klaudiana róży wiktora wojsława
felicja paweł tomasz | felicji pawła tomasza
beata jan julian miligost stefan | beaty jana juliana miłogost miligosta miłogosta stefana
dominik franciszka katarzyna | dominika franciszki katarzyny
aleksander borzysław cyprian | aleksandra borzysława cypriana
benedykt drogosława edwin konstantyn rozyna | benedykta drogosławy edwina konstantyna rozyny
bernard blizbor grzegorz józefina | bernarda blizbora grzegorza józefiny
bożena ernest kasjan krystyna marek | bożeny ernesta kasjana krystyny marka
bożeciecha jakub leon matylda michał | bożeciechy jakuba leona matyldy michała
gościmir klemens krzysztof ludwika | gościmira klemensa krzysztofa ludwiki
henryka herbert izabela | henryki herberta izabeli
gertruda jan patryk zbigniew | gertrudy jana patryka zbigniewa zbyszko zbyszka
aleksander boguchwał cyryl edward | aleksandra boguchwała cyryla edwarda
bogdan józef | bogdana józefa
aleksander bogusław klaudia | aleksandra bogusława klaudii
benedykt lubomira mikołaj | benedykta lubomiry mikołaja
bogusław katarzyna kazimierz paweł | bogusława katarzyny kazimierza pawła
feliks katarzyna piotr | feliksa katarzyny piotra
gabriel marek szymon | gabriela marka szymona
ireneusz łucja lutomysł maria wieńczysław | ireneusza łucji lucja lucji lutomysła marii wieńczysława
emanuel feliks manuela teodor | emanuela feliksa manueli teodora
benedykt ernest jan lidia rupert | benedykta ernesta jana lidii ruperta
aniela antoni jan | anieli antoniego jana
cyryl | cyryla
amelia aniela częstobor jan | amelii anieli częstobora jana
beniamin dobromira kornelia | beniamina dobromiry kornelii
grażyna katarzyna teodora tolisław zbigniew | grażyny katarzyny teodory tolisława zbigniewa zbyszko zbyszka
franciszek sądomir władysław władysława | franciszka sądomira władysława władysławy
antoni cieszygor jakub ryszard | antoniego cieszygora jakuba ryszarda
benedykt izydor wacław wacława | benedykta izydora wacława wacławy
borzywoj irena wincenty jam | borzywoja ireny wincentego jama
ada adam ireneusz katarzyna świętobor | ady adama ireneusza katarzyny świętobora
donata przecław | donaty przecława
cezary radosław sieciesława | cezarego radosława sieciesławy
dobrosława dymitr maja | dobrosławy Demetriusza dymitra mai
antoni daniel henryk małgorzata michał | antoniego daniela henryka małgorzaty michała
filip jaromir leon marek | filipa jaromira leona marka
andrzej iwan juliusz siemiodrog wiktor zenon | andrzeja iwana juliusza siemiodroga wiktora zenona
jan justyn małgorzata marcin przemysł przemysław | jana justyna małgorzaty marcina przemysła przemysława
julianna justyn maria myślimir | julianny justyna marii myślimira
anastazja leonid wacław wacława | anastazji leonida wacława wacławy
erwin julia ksenia nikita nosisław | erwina julii ksenii nikity nosisława
jakub józef klara radociech robert rudolf stefan | jakuba józefa klary radociecha roberta rudolfa stefana
bogusław bogusława gościsław | bogusława bogusławy gościsława
cieszyrad czechasz czesław leon tymon werner włodzimierz | cieszyrada czechasza czesława leona tymona wernera włodzimierza
agnieszka czechoń czesław nawoj szymon teodor | agnieszki czechonia czesława nawoja szymona teodora
bartosz drogomił feliks konrad | bartosza drogomiła feliksa konrada
kajus kaja łukasz teodor | kajusa kai łukasza teodora
gerard helena jerzy wojciech | gerarda heleny jerzego wojciecha
aleksander erwin grzegorz | aleksandra erwina grzegorza
jarosław marek | jarosława marka
maria marzena spycimir | marii marzeny spycimira
andrzej bożebor martyn piotr zyta | andrzeja bożebora martyna piotra zyty
maria paweł | marii pawła
angelina augustyn bogusław piotr robert | angeliny augustyna bogusława piotra roberta
bartłomiej jakub katarzyna marian | bartłomieja jakuba katarzyny mariana
aniela filip jakub józef lubomir maja | anieli filipa jakuba józefa lubomira mai
walter witomir zygmunt wouter | waltera witomira zygmunta woutera
aleksander antonina maria mariola świętosława | aleksandra antoniny marii marioli świętosławy
grzegorz michał monika | grzegorza michała moniki
irena teodor waldemar | ireny teodora waldemara
gościwit jan judyta | gościwita jana judyty
benedykt bogumir ludmiła ludomiła | benedykta bogumira ludmiły ludomiły
marek michał piotr stanisław | marka michała piotra stanisława
bożydar grzegorz karolina mikołaj | bożydara grzegorza karoliny mikołaja
częstomir jan | częstomira jana
filip franciszek iga ignacy lew lutogniew mira żegota | filipa franciszka igi ignacego lwa lutogniewa miry żegoty
dominik jan joanna wszemił pankracy | dominika jana joanny wszemiła pankracego
andrzej ciechosław gloria magdalena piotr robert | andrzeja ciechosława glorii magdaleny piotra roberta
dobiesław wiktor maciej | dobiesława wiktora macieja
jan zofia | jana zofii
andrzej jędrzej szymon wieńczysław | andrzeja jędrzeja szymona wieńczysława
bruno sławomir weronika wiktor | bruna sławomira weroniki wiktora
aleksander aleksandra alicja edwin eryk eryka feliks irena myślibor | aleksandra aleksandry alicji edwina eryka eryki feliksa ireny myślibora
augustyn celestyn mikołaj pękosław piotr timur | augustyna celestyna mikołaja pękosława piotra timura
bronimir teodor wiktoria | bronimira teodora wiktorii
donata jan tymoteusz wiktor | donaty jana tymoteusza wiktora
emil helena jan julia ryta wiesław wiesława wisława | emila heleny jana julii ryty wiesława wiesławy wisławy
budziwoj emilia iwona jan michał | budziwoja emilii iwony jana michała
cieszysława jan joanna maria zula zuzanna | cieszysławy jana joanny marii zuli zuzanny
grzegorz imisława maria magdalena | grzegorza imisławy marii magdaleny
filip marianna paulina ewelina więcemił | filipa marianny pauliny eweliny więcemiła
jan juliusz lucjan magdalena radowit | jana juliusza lucjana magdaleny radowita
augustyn jaromir wiktor wrocimir | augustyna jaromira wiktora wrocimira
bogusława maksymilian maria magdalena teodor urszula | bogusławy maksymiliana marii magdaleny teodora urszuli
feliks joanna | feliksa joanny
aniela bożysława teodor | anieli bożysławy teodora
bernard jakub konrad magdalena nikodem symeon świętopełk | bernarda jakuba konrada magdaleny nikodema symeona świętopełka
eugeniusz maria marianna mikołaj piotr racisław | eugeniusza marii marianny mikołaja piotra racisława
konstantyn leszek paula tamara | konstantyna leszka pauli tamary
franciszek gościmił karol | franciszka gościmiła karola
dobrociech dobromir dobrymir | dobrociecha dobromira dobrymira
dominika norbert paulina więcerad | dominiki norberta pauliny więcerada
antoni ciechomir jarosław paweł robert wiesław wisław | antoniego ciechomira jarosława pawła roberta wiesława wisława
maksym seweryn wyszesław | maksyma seweryna wyszesława
felicjan | felicjana
bogumił edgar małgorzata | bogumiła edgara małgorzaty
feliks radomił | feliksa radomiła
antonina jan leon wyszemir | antoniny jana leona wyszemira
antoni chociemir lucjan maria magdalena tobiasz | antoniego chociemira lucjana marii magdaleny tobiasza
eliza justyn justyna ninogniew | elizy justyna justyny ninogniewa
angelina jolanta witold witolda witosław | angeliny jolanty witolda witołd witołda witoldy witosława
alina aneta budzimir jan justyna | aliny anety budzimira jana justyny
agnieszka drogomysł franciszek laura marcjan radomił | agnieszki drogomysła franciszka laury marcjana radomiła
elżbieta marek marina paula | elżbiety marka mariny pauli
julianna | julianny
bogna bogumiła bożena franciszek michał rafaela rafał | bogny bogumiły bożeny franciszka michała rafaely rafała
alicja domamir marta teodor | alicji domamira marty teodora
broniwoj paulina | broniwoja pauliny
józef piotr wanda zenon | józefa piotra wandy zenona
dan danisz danuta emilia jan | dana danisza danuty emilii jana
lucja tolisława | lucji łucja łucji tolisławy
jan paweł | jana pawła
maria magdalena władysław władysława | marii magdaleny władysławy
ireneusz józef leon paweł | ireneusza józefa leona pawła
dalebor paweł piotr | dalebora pawła piotra
ciechosława emilia lucyna | ciechosławy emilii lucyny
halina marian | haliny mariana
maria piotr jagoda | marii piotra jagody
jacek leon miłosław | jacka leona miłosława
elżbieta józef julian teodor wielisław | elżbiety józefa juliana teodora wielisława
antoni bartłomiej jakub karolina michał | antoniego bartłomieja jakuba karoliny michała
chociebor dominik dominika lucja niegosław | chociebora dominiki łucja łucji lucji niegosława
antoni kira piotr benedykt cyryl | antoniego kiry piotra benedykta cyryla
adrian adrianna chwalimir edgar elżbieta eugeniusz | adriana adrianny chwalimira edgara elżbiety eugeniusza
lucja mikołaj weronika zenon | łucja łucji lucji mikołaja weroniki zenona
aleksander amelia aniela filip | aleksandra amelii anieli filipa
cyprian kalina olga | cypriana kaliny olgi
andrzej euzebiusz feliks henryk paweł piotr tolimir weronika | andrzeja euzebiusza feliksa henryka pawła piotra tolimira weroniki
ernest eugeniusz jakub justyna małgorzata radomiła sara | ernesta eugeniusza jakuba justyny małgorzaty radomiły sary
damian dobrogost franciszek izabela marcelina | damiana dobrogosta franciszka izabeli marceliny
daniel dawid henryk iga ignacy lubomysł niecisław włodzimierz żegota | daniela dawida henryka igi ignaciego lubomysła niecisława włodzimierza żegoty
andrzej maria magdalena marika stefan | andrzeja marii magdaleny mariki stefana
aleksander andrzej bogdan marcelina maria magdalena aneta | aleksandra andrzeja bogdana marceliny marii magdaleny anety
erwin kamil karolina robert szymon unisław | erwina kamili karoliny roberta szymona unisława
lutobor wincenty | lutobora wincentego
czechoń czesław małgorzata paweł | czechonia czesława małgorzaty pawła
andrzej daniel paulina stojsław wiktor | andrzeja daniela pauliny stojsława wiktora
bolesława bolisława maria magdalena milenia więcemiła | bolesławy bolisławy marii magdaleny milenii więcemiły
bogna żelisław | bogny żelisława
antoni kinga krystyna olga wojciecha | antoniego kingi krystyny olgi wojciechy
jakub krzysztof sławosz walentyna | jakuba krzysztofa sławosza walentyny
anna baldev grażyna mirosława | anny baldeva grażyny mirosławy
julia marta natalia wszebor | julii marty natalii wszebora
marcela świętomir wiktor | marceli świętomira wiktora
konstantyn maria marta | konstantyna marii marty
julia julita ludmiła maryna | julii julity ludmiły maryny
emilian helena iga ignacy ludomir | emiliana heleny igi ignacego ludomira
konrad piotr | konrada piotra
borzysława karina maria stefan | borzysławy kariny marii stefana
augusta lidia nikodem szczepan | augusty lidii nikodema szczepana
dominik maria mironieg | dominika marii mironiega
emil maria stanisława | emila marii stanisławy
jakub sława stefan wincenty | jakuba sławy stefana wincentego
anna dobiemir donata dorota kajetan | anny dobiemira donaty doroty kajetana
cyprian cyryl emil emilian emiliusz | cypriana cyryla emila emiliana emiliusza
jan klarysa miłorad roman | jana klarysy miłorada romana
bogdan borys | bogdana borysa
aleksander włodzimierz włodziwoj zula zuzanna | aleksandra włodzimierza włodziwoja zuli zuzanny
klara lech piotr | klary lecha piotra
diana helena jan kasjan radomiła wojbor | diany heleny jana kasjana radomiły wojbora
dobrowoj euzebiusz | dobrowoja euzebiusza
maria stefan | marii stefana
domarad domarat joachim | domarada domarata joachima
anastazja angelika anita eliza jacek jaczewoj joanna julianna miron żanna | anastazji angeliki anity elizy jacka jaczewoja joanny julianny mirona żanny
bogusława bronisław bronisz helena ilona klara | bogusławy bronisława bronisza heleny ilony klary
bolesław emilia jan julian juliusz piotr | bolesława emilii jana juliana juliusza piotra
jan samuel samuela sieciech sobiesław świeciech | jana samueli sieciecha sobiesława świeciecha
emilian filipina franciszek joanna kazimiera męcimir | emiliana filipiny franciszka joanny kazimiery męcimira
cezary dalegor maria namysław tymoteusz zygfryd | cezarego dalegora marii namysława tymoteusza zygfryda
filip laurenty | filipa laurentego
bartłomiej cieszymir jerzy joanna malina michalina | bartłomieja cieszymira jerzego joanny maliny michaliny
grzegorz luiza michał sieciesław | grzegorza luizy michała sieciesława
dobroniega joanna konstanty maksym maria | dobroniegi joanny konstantego maksyma marii
cezary józef monika małgorzata teodor | cezarego józefa moniki małgorzaty teodora
adelina aleksander aleksy augustyn patrycja sobiesław stronisław | adeliny aleksandra aleksego augustyna patrycji sobiesława stronisława
gita jan racibor sabina | gity jana racibora sabiny
częstowoj miron rebeka róża szczęsna szczęsny | częstowoja mirona rebeki róży szczęsnego
bohdan paulina rajmund świętosław | bohdana pauliny rajmunda świętosława
bronisław bronisława bronisz | bronisławy bronisza
bohdan czesław eliza henryk julian stefan tobiasz witomysł | bohdana czesława elizy henryka juliana stefana tobiasza witomysła
antoni bartłomiej bronisław bronisz izabela jan joachim mojmir szymon wincenty zenon | antoniego bartłomieja bronisława bronisza izabeli jana joachima mojmira szymona wincentego zenona
ida lilianna rościgniew róża rozalia | idy lilianny rościgniewa róży rozalii
dorota justyna stronisława wawrzyniec | doroty justyny stronisławy wawrzyńca
albin beata eugenia eugeniusz michał uniewit | albina beaty eugenii eugeniusza michała uniewita
domasława domisława marek regina rena ryszard | domasławy domisławy marka reginy reny ryszarda
adrian adrianna maria radosław radosława klementyna | adriana adrianny marii radosławy klementyny
augustyna aureliusz piotr ścibor ścibora sergiusz sobiesąd | augustyny aureliusza piotra ścibory sergiusza sobiesąda
aldona łukasz mikołaj mścibor | aldony łukasza mikołaja mścibora
feliks jacek jan naczesław | feliksa jacka jana naczesława
amadeusz maria piotr sylwin | amadeusza marii piotra sylwina
aleksander eugenia filip lubor morzysław szeliga | aleksandra eugenii filipa lubora morzysława szeligi
bernard cyprian roksana siemomysł szymon | bernarda cypriana roksany siemomysła szymona
maria nikodem | marii nikodema
cyprian edyta eugenia franciszek kamila kornel lucja wiktor | cypriana edytu eugenii franciszka kamili kornela łucja lucji łucji wiktora
drogosław franciszek justyn justyna teodora | drogosława franciszka justyny teodory
dobrowit irena józef stefania | dobrowita ireny józefa stefanii
konstancja teodor więcemir | konstancji teodora więcemira
agnieszka barbara dionizy eustachiusz eustachy fausta faustyna filipina irena klemens mieczysława miłowuj oleg perpetua protazy | agnieszki barbary dionizego eustachiusza eustachego fausty faustyny filipiny ireny klemensa mieczysławy miłowuja olega perpetui protazego
bożeciech bożydar jonasz laurenty mateusz mira | bożeciecha bożydara jonasza laurentego mateusza miry
joachim maurycy prosimir scott tomasz | joachima maurycego prosimira scotta tomasza
boguchwała bogusław elżbieta krzysztof libert litoriusz liwiusz piotr tekla zachariusz | boguchwały bogusława elżbiety krzysztofa liberta litoriusza liwiusza piotra tekli zachariusza
gerard maria teodor tomir uniegost | gerarda marii teodora tomira uniegosta
aurelia franciszek kamil ładysław piotr świętopełk wincenty władysław władysława | aurelii franciszka kamila ładysława piotra świętopełka wincentego władysławy
cyprian euzebiusz justyna łękomir | cypriana euzebiusza justyny łękomira
amadeusz damian | amadeusza damiana
jan luba lubosza marek nikita sylwin wacław wacława więcesław | jana luby luboszy marka nikity sylwina wacławy więcesława
michał rafał gabriel | michała rafała gabriela
grzegorz hieronim honoriusz imisław rachela wera wiera wiktor zofia | grzegorza hieronima honoriusza imisława racheli wery wiery wiktora zofii
danuta remigiusz cieszysław dan danisz danuta igor jan remigiusz | danuty remigiusza cieszysława dana danisza danuty igora jana remigiusza
stanimir teofil | stanimira teofila
gerard józefa sierosław teresa | gerarda józefy sierosława teresy
edwin franciszek konrad rozalia | edwina franciszka konrada rozalii
częstogniew donata igor justyn konstancjusz | częstogniewa donaty igora justyna konstancjusza
artur bronisław bronisz emil roman | artura bronisława bronisza emila romana
justyna marek maria rościsława stefan mirella | justyny marka marii rościsławy stefana mirelli
bryda brygida laurencja marcin wojsława | brydy brygidy laurencji marcina wojsławy
bogdan jan ludwik | bogdana jana ludwika
franciszek lutomir tomił | franciszka lutomira tomiła
aldona dobromiła emil emilian emiliusz maria marian | aldony dobromiły emila emiliana emiliusza marii mariana
maksymilian witold | maksymiliana witolda
daniel edward mikołaj siemisław | daniela edwarda mikołaja siemisława
alan bernard dominik | alana bernarda dominika
jadwiga teresa | jadwigi teresy
aurelia gerard grzegorz | aurelii gerarda grzegorza
lucyna małgorzata marian wiktor | lucyny małgorzaty mariana wiktora
julian łukasz | juliana łukasza
ferdynand piotr siemowit skarbimir ziemowit | ferdynanda piotra siemowita skarbimira ziemowita
irena urszula | ireny urszuli
bernard celina dobromił elżbieta | bernarda celiny dobromiła elżbiety
filip halka | filipa halki
iga ignacy jan marlena roman seweryn teodor włościsław żegota | igi ignacego jana marleny romana seweryna teodora włościsława żegoty
antoni boleczest filip marcin rafaela rafał | antoniego boleczesta filipa marcina rafaeli rafała
daria kryspin sambor taras | darii kryspina sambora tarasa
dymitriusz łucjan lucyna ludmiła lutosław | dymitriusza łucjana lucyny ludmiły lutosława
iwona sabina wincenty | iwony sabiny wincentego
szymon tadeusz wszeciech | szymona tadeusza wszeciecha
euzebia franciszek lubogost teodor wioletta | euzebii franciszka lubogosta teodora wioletty
edmund klaudiusz przemysław sądosław | edmunda klaudiusza przemysława sądosława
antoni antonina godzimir lucylla łukasz dezemir | antoniego antoniny godzimira lucylli łukasza dezemira
andrzej seweryn warcisław wiktoryna | andrzeja seweryna warcisława wiktoryny
bohdana bożydar małgorzata stojmir tobiasz | bohdany bożydara małgorzaty stojmira tobiasza
bogumił cezary chwalisław hubert sylwia | bogumiła cezarego chwalisława huberta sylwii
mściwój olgierd karol | mściwója olgierda karola
dalemir elżbieta florian sławomir | dalemira elżbiety floriana sławomira
feliks leonard trzebowit ziemowit | feliksa leonarda trzebowita ziemowita
antoni florentyn przemił | antoniego florentyna przemiła
dymitr klaudiusz seweryn wiktor | dymitra klaudiusza seweryna wiktora
bogudar genowefa teodor ursyn | bogudara genowefy teodora ursyna
andrzej lena leon ludomir stefan | andrzeja leny leona ludomira stefana
anastazja bartłomiej maciej marcin spycisław teodor | anastazji bartłomieja macieja marcina spycisława teodora
cibor czcibor jonasz krystyn marcin renata witold | cibora czcibora jonasza krystyny marcina renaty witolda
arkadiusz eugeniusz jan mikołaj stanisław | arkadiusza eugeniusza jana mikołaja stanisława
aga agata damian elżbieta emil emiliusz józef judyta ścibor ścibora wszerad | agi agaty damiana elżbiety emila emiliusza józefa judyty ścibory wszerada
albert alfons artur gurias idalia józef leopold leopoldyna przybygniew roger | alberta alfonsa artura guriasa idalii józefa leopolda leopoldyny przybygniewa rogera
edmund marek maria niedamir otomar paweł piotr | edmunda marka marii niedamira otomara pawła piotra
grzegorz | grzegorza
aniela cieszymysł klaudyna roman tomasz | anieli cieszymysła klaudyny romana tomasza
elżbieta mironiega paweł seweryn | elżbiety mironiegi pawła seweryna
edmund feliks sędzimir | edmunda feliksa sędzimira
janusz konrad maria piotr regina rena twardosław wiesław | janusza konrada marii piotra reginy reny twardosława wiesława
cecylia marek wszemiła | cecylii marka wszemiły
adela klemens przedwoj | adeli klemensa przedwoja
dobrosław emilia emma franciszek gerard jan pęcisław | dobrosława emilii emmy franciszka gerarda jana pęcisława
katarzyna tęgomir | katarzyny tęgomira
dobiemiest jan konrad lechosław lechosława leonard sylwester | dobiemiesta jana konrada lechosławy leonarda sylwestera
dominik maksymilian stojgniew walery | dominika maksymiliana stojgniewa walerego
gościrad grzegorz jakub lesław lesława zdzisław | gościrada grzegorza jakuba lesława lesławy zdzisława
błażej bolemysł fryderyk przemysł | błażeja bolemysła fryderyka przemysła
andrzej justyna konstanty | andrzeja justyny konstantego
blanka długosz edmund iwa natalia sobiesława | blanki długosza edmunda iwy natalii sobiesławy
aurelia balbina bibiana budzisław budzisława ludwina paulina sulisław sylweriusz sylwery wiktoryn zbylut | aurelii balbiny bibiany budzisławy ludwiny pauliny sulisława sylweriusza sylwerego wiktoryna zbyluta
franciszek kasjan lucjusz unimir | franciszka kasjana lucjusza unimira
barbara hieronim krystian piotr | barbary hieronima krystiana piotra
gerald krystyna pęcisława | geralda krystyny pęcisławy
emilian jarogniew mikołaj | emiliana jarogniewa mikołaja
marcin ninomysł | marcina ninomysła
boguwola maria światozar | boguwoli marii światozara
joachim wielisława wiesław | joachima wielisławy wiesława
andrzej daniel judyta julia maria | andrzeja daniela judyty julii marii
daniela julia stefan waldemar wojmir | danieli julii stefana waldemara wojmira
aleksander dagmara | aleksandra dagmary
lucja otylia | lucji łucja łucji otylii
alfred izydor sławobor | alfreda izydora sławobora
celina iga ignacy krystiana nina wolimir żegota | celiny igi ignacego krystiany niny wolimira żegoty
alina zdzisława | aliny zdzisławy
florian jolanta żyrosław | floriana jolanty żyrosława
bogusław gracjan laurencja wszemir | bogusława gracjana laurencji wszemira
beniamin dariusz gabriela mścigniew tymoteusz | beniamina dariusza gabrieli mścigniewa tymoteusza
bogumiła dominik | bogumiły dominika
tomasz tomisław | tomasza tomisława
beata drogomir franciszka zenon | beaty drogomira franciszki zenona
sławomir sławomira wiktoria | sławomiry wiktorii
adam adamina adela ewa ewelina grzegorz | adama adaminy adeli ewy eweliny grzegorza
anastazja eugenia piotr | anastazji eugenii piotra
szczepan wróciwoj | szczepana wróciwoja
cezary jan radomysł | cezarego jana radomysła
antoni dobrowiest emma | antoniego dobrowiesta emmy
domawit dominik gosław jonatan marcin tomasz | domawita dominika gosława jonatana marcina tomasza
dawid eugeniusz katarzyna uniedrog | dawida eugeniusza katarzyny uniedroga
korneliusz melania sebastian sylwester tworzysław | korneliusza melanii sebastiana sylwestera tworzysława
